-------##----------##------------------
-------##----------##------------------
-------##----------==----==----==------
-------##----------==----==----==------
-----------------====----==####==------
-----------------====----==####==------
---------------------------------------
---------------------------------------
---------------------------------------
---------------------------------------
---------------------------------------
---------------------------------------
---------------------------------------
---------------------------------------
---------------------------------------
---------------------------------------
***-----------------------===----------
***-----------------------===----------
******---------==-------##---****------
******---------==-------##---****------
----========**********##-----****------
----========**********##-----****------
----------##***==-----==-----****------
----------##***==-----==-----****------
----------##---==-----==-----****------
####==----##---==-----==-----****------
####==----##---=========---==----==----
----==----==---=========---==----==----
----==----==---=========---------==----
----==----==---=========---------==----
----==----==---=========---------==----
----==----==---=========---------==----
----==----==---=========---==####==----
----==---------=========---==####==----
----==---------------------------------
----==---------------------------------
----==----==-----====------==----==----
----==----==-----=@@=------========----
----==----==-----=@@=------========----