--###----
--#.#----
--#-####-
###$@$.#-
#.-$-###-
####$#---
---#.#---
---###---
Title: aaabbcc
Author: dn   
