-######-
-#----#-
-#$##.#-
##-##.##
#---$.-#
#-$@---#
###--###
--####--