########
##--####
##-..--#
#-$.*$-#
#---.-##
###-*-##
###-$###
###$-###
###@-###
########