#############
##.       $ #
########### #
##    #   # #
##$## # $ # #
## ## ### # #
## ##    .# #
#   # ##### #
#.  #       #
##$### ###$##
#   # $.#   #
#  .# @ #.  #
#############