-######-----
##----#-----
#--##-#-----
#-##--####--
#-#-.-.-.#--
#-#-$-$-$###
#-#-.#.#.--#
#-#-$-$@$--#
#-##-#######
#----#------
######------