#################
#---------------#
#---------------#
#---------------#
#------@--------#
#---------------#
#---------------#
#---------------#
#################

Title: test key
Author: hulang