########-########
#-.-.-*#-#*-.-.-#
#-*-#-##-##-#-*-#
#-*-#-#-#-#-#-*-#
#-*-#-#---#-#-*-#
#-*-#-#-$-#-#-*-#
#-*-#-#---#-#-*-#
#-*-*-#---#-*-*-#
#--*-*#---#*-*--#
##--*-##-##-*--##
-##--*-#$#-*--##-
--##--*-*-*--##--
---##--*.*--##---
#####$-*+*--#####
#-----*-#-*-----#
#-*#**$*$*$**#*-#
#---------------#
#################

Title: Recreation / Level 91 (Remodel ) (31)
Author: Werner Ettinger & xht2xsb & TIAOA